R 2000 1350

NO ./texture/greystone.xpm
SO ./texture/mossy.xpm
WE ./texture/redbrick.xpm
EA ./texture/wood.xpm

S ./texture/sprite.xpm
F 10,200,10
C 10,10,200
    1 1 1 1 1 1 1 1 1 1 1
    1 0 0 0 0 0 0 0 0 2 0 1
    1 0 0 0 0 0 0 0 0 0 0 1
    1 0 0 0 0 0 0 0 0 0 0 1
    1 1 0 0 0 0 0 0 0 0 0 1
    1 0 0 0 W 0 0 0 0 1 1
1 1 1 1 1 1 1 1 1
